11111111111111111111111111
1E100000000000000000000001
1P101111111111111111111101
10101000000000000000000101
10101011111111111111110101
1010101C000000000000010101
10101011111111111111010101
10101000000000000000010101
10101111111111111111110101
10100000000000000000000101
10111111111111111111111101
10000000000000000000000001
11111111111111111111111111