11111111111111111111111111111111111
1P000000000000000000000000000000001
10011111101000000111111010000010001
1001C0000010000001C0000001000100001
100100000010000001000000001E1000001
10011111001000000111111000C1C000001
1001C0000010000001C00000001C1000001
10010000001C00000100000001000100001
10010000001111110111111010000010001
10000000000000000000000000000000001
100CCCC0C00000CCCCC0C000C0000000001
100C0000C00000C000000C0C00000000001
100CCC00C00000CCCCC000C000000000001
100C0000C00000C000000C0C00000000001
100C0000CCCCC0CCCCC0C000C0000000001
11111111111111111111111111111111111