111111
1P0001
101101
1000E1
111111