111111
10P1C1
100011
10C0E1
111111