

111111111
1C0P000C1
1011E1111
10C000C11
111111111

