111111
10P0C1
101100
10C0E1
111111