11111111
10P0C001
10110001
10110001
101100001
10C0E001
11111111